###########################
#                         #
# # # ### #   #   ### ### #
# # # #   #   #   # # # # #
# ### ### #   #   # # # # #
# # # #   #   #   # # # # #
# # # ### ### ### ### ### #
#                         #
#                         #
#         #               #
#                         #
#                         #
#                         #
#                         #
#                          
#                          
#           #              
#                         #
#                         #
# #                       #
#                         #
#                         #
#                         #
#                         #
#                         #
#                         #
###########################