#############
#           #
# ###   ### #
# #   #   # #
# #       # #
#           #
#  #     #  #
#           #
# #       # #
# #   #   # #
# ###   ### #
#           #
#############