###########################
#                         #
# #   #   #######   #   # #
# #   #   #     #   #   # #
# #   #   #     #   #   # #
# #   #   #     #   #   # #
# # X # X #     # X # X # #
# #   #   #     #   #   # #
# #   #   #     #   #   # #
# #   #   #     #   #   # #
# #   #   #######   #   # #
#                         #
###########################