#########################################################
#                                                       #
#                                                       #
#                                                       #
#                                                       #
#                                                       #
#                                                       #
#                                                       #
#                                                       #
#                                                       #
#                                                       #
#                                                       #
#                                                       #
#                                                       #
#                                                       #
#                                                       #
#                                                       #
#                                                       #
#########################################################